6 2 4 2 4 2 3 4 5
1 2 1 3 2 5 3 4 2
5 3 2 6 4 3 3 1 3
2 2 4 2 5 2 5 2 1
4 5 4 2 5 2 3 4 5
3 2 3 3 2 6 3 4 2
5 3 2 2 4 3 3 1 3
2 2 4 1 1 2 5 4 1